; WALL   #
; PLAYER @
; CRATE  .
; TARGET X
########
########
### ####
#@ X  .#
### ####
########
########
########
