########
#@     #
#.# X  #
#.# X  #
#.# X  #
#      #
#      #
####### 
;
