;
#   # # 
#@     #
#.# X  #
# # ## #
#.# X  #
# #### #
#.  X   
#       
;
