########
#@     #
  #. X #
   #.  #
    #. #
  XXX  #
#.     #
########
