########
#@     #
# #.#  #
# #X   #
  .. X##
 X#X   #
  #.#  #
       #
