#  #####
#@     #
#.# X  #
#.# X  #
#.  X  #
#.# X  #
#      #
########
