########
###    #
#    X.#
#      #
#  ### #
#   ####
##   @ #
########
