########
#      #
#@   . #
#  ### #
#   #  #
#  X   #
## # ###
##   ###
