########
#@     #
# #### #
#   X  #
# #### #
#      #
#.     #
########
