########
#@     #
# .# X #
# .# X #
#      #
#      #
#      #
########
