########
#@     #
#  X X #
# ## # #
# X X  #
#    ..#
#    ..#
########
