########
#@     #
#.#    #
# ###X #
# .    #
#   X  #
#      #
########
