####   .
#@   X #
#. # # #
#  . X #
# ###  #
  X    #
   X   #
.  #####
